__________________
......s.__........
..................
........__.......b
_....________...._
_....________...._
.....c._.._.......
..................
..................
......._@._.......