____________________
____________________
____________________
...c........#.....t.
.....#.s........#...
...#.....#........#.
....#.......#.......
..s....#...s......#.
.......s............
...#.....#.....#....
...........#.....@..