__________________
__________________
__________________
............t.....
.....c..........t.
...t.....t........
....c.......c.....
.......t..........
..................
...c.....c.....c..
.....@.....t......