__________________
__________________
__________________
__________________
__________________
___...........@___
___...__.__.__.___
__________________
__________________
__________________
